i,timestamp,prev_timestamp,delta,difficulty,boundary
1,1515662003,1515270948,391055,5000,23158417847463239084714197001737581570653996933128112807891516801582625927
2,1515662012,1515662003,9,2,57896044618658097711785492504343953926634992332820282019728792003956564819968
3,1515662022,1515662012,10,3,38597363079105398474523661669562635951089994888546854679819194669304376546645
4,1515662022,1515662022,0,4,28948022309329048855892746252171976963317496166410141009864396001978282409984
5,1515662023,1515662022,1,6,19298681539552699237261830834781317975544997444273427339909597334652188273322
6,1515662023,1515662023,0,9,12865787693035132824841220556520878650363331629515618226606398223101458848881
7,1515662024,1515662023,1,14,8270863516951156815969356072049136275233570333260040288532684571993794974281
8,1515662029,1515662024,5,22,5263276783514372519253226591303995811512272030256389274520799273086960438178
9,1515662032,1515662029,3,35,3308345406780462726387742428819654510093428133304016115413073828797517989712
10,1515662039,1515662032,7,56,2067715879237789203992339018012284068808392583315010072133171142998448743570
11,1515662042,1515662039,3,87,1330943554451910292224953850674573653485861892708512230338592919631185398160
12,1515662049,1515662042,7,141,821220491044795712223907695097077360661489252947805418719557333389454820141
13,1515662059,1515662049,10,220,526327678351437251925322659130399581151227203025638927452079927308696043817
14,1515662072,1515662059,13,343,337586265998006400651810451920372909193206952377960828103374880489542652011
15,1515662092,1515662072,20,514,225276438204895321835741215970209937457723705575176194629294910521231769727
16,1515662102,1515662092,10,738,156899849915062595424892933616108276223943068652629490568370710037822668888
17,1515662114,1515662102,12,1153,100426790318574323871267116226095323376643525295438477050700419781364379566
18,1515662123,1515662114,9,1729,66970554793126775837808551190681265386506642374575225008361818396710890480
19,1515662134,1515662123,11,2701,42870081168943426665520542394923327602099216832891730484804733064758655920
20,1515662183,1515662134,49,4220,27438883705525164792315399291158272003144546129298711857691370617988893279
21,1515662264,1515662183,81,4747,24392687852815714224472505794962693881034334245974418377808633665033311489
22,1515662343,1515662264,79,3857,30021283183125796065224522947546774138778839685154411210644953074387640560
23,1515662363,1515662343,20,3134,36947061020202997901586147099134622799384168687185885143413396301184789291
24,1515662403,1515662363,40,4505,25703016478871519516885901222794208180526078727112222872243636849703247422
25,1515662443,1515662403,40,5631,20563326094355566582058423904934808711289288699279091465007562423710376423
26,1515662584,1515662443,141,7038,16452413929712446067571893294783732289467175996823041210494115374810049678
27,1515662663,1515662584,79,1320,87721279725239541987553776521733263525204533837606487908679987884782673969
28,1515662724,1515662663,61,1073,107914342252857591261482744649289755688042856165555045703129155645771789040
29,1515662801,1515662724,77,1073,107914342252857591261482744649289755688042856165555045703129155645771789040
30,1515662833,1515662801,32,939,123314259038675394487296043672724076521054296768520302491435126738991618359
31,1515662864,1515662833,31,1232,93987085419899509272379046273285639491290571968864094187871415590838579253
32,1515662913,1515662864,49,1617,71609207938971054683717368589170011040983292928658357476473459497781774669
33,1515662943,1515662913,30,1819,63657003428980866093222091813462291288218793109203168795743586590386547355
34,1515663043,1515662943,100,2387,48509463442528778979292410979760330060020940371026629258256214498497331227
35,1515663065,1515663043,22,1492,77608638899005492911240606574187605799778810097614319061298648798869389839
36,1515663084,1515663065,19,2144,54007504308449718014725272858529807767383388370168173525866410451452019421
37,1515663155,1515663084,71,3082,37570437779791108184156711553759866272962357127073512017994024661879665684
38,1515663174,1515663155,19,2890,40066466864123251011616257788473324516702416839321994477320963324537415100
39,1515663204,1515663174,30,4154,27874840933393402846309818249563771750907555287828734723027824749136526153
40,1515663274,1515663204,70,5452,21238460975296440833376923149062345534348859990029450484126482760072107417
41,1515663537,1515663274,263,5112,22651034670836501452185247458663518750639668361823271525715489829403976846
42,1515663538,1515663537,1,2,57896044618658097711785492504343953926634992332820282019728792003956564819968
43,1515663538,1515663538,0,3,38597363079105398474523661669562635951089994888546854679819194669304376546645
44,1515663538,1515663538,0,4,28948022309329048855892746252171976963317496166410141009864396001978282409984
45,1515663539,1515663538,1,6,19298681539552699237261830834781317975544997444273427339909597334652188273322
46,1515663540,1515663539,1,9,12865787693035132824841220556520878650363331629515618226606398223101458848881
47,1515663542,1515663540,2,14,8270863516951156815969356072049136275233570333260040288532684571993794974281
48,1515663543,1515663542,1,22,5263276783514372519253226591303995811512272030256389274520799273086960438178
49,1515663544,1515663543,1,35,3308345406780462726387742428819654510093428133304016115413073828797517989712
50,1515663548,1515663544,4,56,2067715879237789203992339018012284068808392583315010072133171142998448743570
51,1515663550,1515663548,2,91,1272440541069408740918362472622944042343626205116929275158874549537506919120
52,1515663551,1515663550,1,147,787701287328681601520891054480870121450816222215241932241208054475599521360
53,1515663575,1515663551,24,238,486521383350068047998197416002890369131386490191767075796040268940811469075
54,1515663578,1515663575,3,327,354104248432159619032327171280391155514587109069237198897423804305544738960
55,1515663598,1515663578,20,531,218064198187036149573580009432557265260395451347722342823837258018668794048
56,1515663614,1515663598,16,763,151758963613782693870997359120167638077680189601101656670324487559519173840
57,1515663674,1515663614,60,1144,101216861221430240754869742140461457913697539043392101433092293713210777657
58,1515663694,1515663674,20,1144,101216861221430240754869742140461457913697539043392101433092293713210777657
59,1515663696,1515663694,2,1644,70433144304936858530152667280223788231916049066691340656604369834497037493
60,1515663865,1515663696,169,2671,43351587134899361820880189071017561906877568201288118322522494948675825398
61,1515663865,1515663865,0,2,57896044618658097711785492504343953926634992332820282019728792003956564819968
62,1515663865,1515663865,0,3,38597363079105398474523661669562635951089994888546854679819194669304376546645
63,1515663866,1515663865,1,4,28948022309329048855892746252171976963317496166410141009864396001978282409984
64,1515663866,1515663866,0,6,19298681539552699237261830834781317975544997444273427339909597334652188273322
65,1515663866,1515663866,0,9,12865787693035132824841220556520878650363331629515618226606398223101458848881
66,1515663867,1515663866,1,14,8270863516951156815969356072049136275233570333260040288532684571993794974281
67,1515663868,1515663867,1,22,5263276783514372519253226591303995811512272030256389274520799273086960438178
68,1515663871,1515663868,3,35,3308345406780462726387742428819654510093428133304016115413073828797517989712
69,1515663878,1515663871,7,56,2067715879237789203992339018012284068808392583315010072133171142998448743570
70,1515663885,1515663878,7,87,1330943554451910292224953850674573653485861892708512230338592919631185398160
71,1515663887,1515663885,2,135,857719179535675521656081370434725243357555441967707881773759881540097256592
72,1515663894,1515663887,7,219,528731001083635595541420022870721040425890340938998009312591707798690089680
73,1515663905,1515663894,11,342,338573360343029811180032119908444175009561358671463637542273637450038390760
74,1515663914,1515663905,9,534,216839118421940440868110458817767617702752780272735138650669632973620092958
75,1515663924,1515663914,10,834,138839435536350354224905257804182143708956816145851995251148182263684807721
76,1515663955,1515663924,31,1303,88865763037080733249095153498609292289539512406477792816160847281591043468
77,1515663963,1515663955,8,1710,67714672068605962236006423981688835001912271734292727508454727490007678152
78,1515663984,1515663963,21,2671,43351587134899361820880189071017561906877568201288118322522494948675825398
79,1515664004,1515663984,20,3839,30162044604666891227812186769650405796631931405480740828199422768406650075
80,1515664034,1515664004,30,5518,20984430815026494277559076659783963003492204542522755353290609642608396092
81,1515664154,1515664034,120,7242,15988965650002236319189586441409542647510354137757603429916816350167513068
82,1515664166,1515664154,12,2716,42633317097686375340048227175511011728008094501340413858415899855638118424
83,1515664247,1515664166,81,4074,28422211398457583560032151450340674485338729667560275905610599903758745616
84,1515664275,1515664247,28,3311,34971938760892840659489877683083028647922073290740128069905643010544587629
85,1515664425,1515664275,150,4552,25437629445807600049114891258499101022247360427425431467367659052704993330
86,1515664427,1515664425,2,285,406288032411635773416038543890133010011473630405756365050728364940046068912
87,1515664435,1515664427,8,463,250090905480164568949397375828699584996263465800519576759087654444736781079
88,1515664445,1515664435,10,723,160155033523258914832048388670384381539792509910982799501324459208731852890
89,1515664446,1515664445,1,1129,102561637942706993289256851203443673917865353999681633338757824630569645385
90,1515664454,1515664446,8,1834,63136362724817990961598137954573559352928017811145345713989958564838129574
91,1515664475,1515664454,21,2865,40416086993827642381700169287500142357162298312614507518135282376234949263
92,1515664485,1515664475,10,4118,28118525798279794906160996845237471552518209000884061204336470133053212637
93,1515664526,1515664485,41,6434,17996905383480913183644853125378910141944355714274256145392847996256314833
94,1515664665,1515664526,139,8042,14398419452538696272515665880214860464221584763198279537361052475492803984
95,1515664695,1515664665,30,1508,76785205064533286089901183692763864624184339963952628673380360747953003740
96,1515664715,1515664695,20,1979,58510403859179482275680133910403187394274878557675878746567753414812091783
97,1515664726,1515664715,11,2844,40714518015933964635573482773800248893554846928846893122172146275637528002
98,1515664785,1515664726,59,4443,26061690127687642454101054469657417927812285542570462309128423139300726905
99,1515664845,1515664785,60,4720,24532222296041566827027751061162692341794488276618763567681691527100239330
100,1515664886,1515664845,41,4720,24532222296041566827027751061162692341794488276618763567681691527100239330
101,1515664946,1515664886,60,5900,19625777836833253461622200848930153873435590621295010854145353221680191464
102,1515664966,1515664946,20,5900,19625777836833253461622200848930153873435590621295010854145353221680191464
103,1515664975,1515664966,9,8481,13653117466963352838529770664861208330771133671222799674502721849771622407
104,1515665136,1515664975,161,13251,8738366103487751522418759716903472028772921641056566601724970493390169016
105,1515665136,1515665136,0,2,57896044618658097711785492504343953926634992332820282019728792003956564819968
106,1515665136,1515665136,0,3,38597363079105398474523661669562635951089994888546854679819194669304376546645
107,1515665136,1515665136,0,4,28948022309329048855892746252171976963317496166410141009864396001978282409984
108,1515665137,1515665136,1,6,19298681539552699237261830834781317975544997444273427339909597334652188273322
109,1515665137,1515665137,0,9,12865787693035132824841220556520878650363331629515618226606398223101458848881
110,1515665137,1515665137,0,14,8270863516951156815969356072049136275233570333260040288532684571993794974281
111,1515665137,1515665137,0,22,5263276783514372519253226591303995811512272030256389274520799273086960438178
112,1515665138,1515665137,1,35,3308345406780462726387742428819654510093428133304016115413073828797517989712
113,1515665138,1515665138,0,56,2067715879237789203992339018012284068808392583315010072133171142998448743570
114,1515665139,1515665138,1,91,1272440541069408740918362472622944042343626205116929275158874549537506919120
115,1515665140,1515665139,1,147,787701287328681601520891054480870121450816222215241932241208054475599521360
116,1515665145,1515665140,5,238,486521383350068047998197416002890369131386490191767075796040268940811469075
117,1515665150,1515665145,5,386,299979505796155946693189080333388362314170944729638766941599958569723133782
118,1515665156,1515665150,6,627,184676378368925351552744792677333186368851650184434711386694711336384576778
119,1515665165,1515665156,9,979,118275882775603876837151159355145973292410607421491893809456163440156414341
120,1515665175,1515665165,10,1529,75730601201645647759039231529553896568521899715919270136989917598373531484
121,1515665176,1515665175,1,2389,48468852757352949109908323569982380851096686758325895370220838848017216257
122,1515665177,1515665176,1,3882,29827946738103090011223849821918574923562592649572530664466147348766906141
123,1515665186,1515665177,9,6308,18356387006549809039881259513108419127024411012308269505303992391869551306
124,1515665198,1515665186,12,9856,11748385677487438659047380784160704936411321496108011773483926948854822406
125,1515665356,1515665198,158,14784,7832257118324959106031587189440469957607547664072007848989284632569881604
126,1515665356,1515665356,0,2,57896044618658097711785492504343953926634992332820282019728792003956564819968
127,1515665356,1515665356,0,3,38597363079105398474523661669562635951089994888546854679819194669304376546645
128,1515665357,1515665356,1,4,28948022309329048855892746252171976963317496166410141009864396001978282409984
129,1515665357,1515665357,0,6,19298681539552699237261830834781317975544997444273427339909597334652188273322
130,1515665357,1515665357,0,9,12865787693035132824841220556520878650363331629515618226606398223101458848881
131,1515665357,1515665357,0,14,8270863516951156815969356072049136275233570333260040288532684571993794974281
132,1515665357,1515665357,0,22,5263276783514372519253226591303995811512272030256389274520799273086960438178
133,1515665358,1515665357,1,35,3308345406780462726387742428819654510093428133304016115413073828797517989712
134,1515665359,1515665358,1,56,2067715879237789203992339018012284068808392583315010072133171142998448743570
135,1515665362,1515665359,3,91,1272440541069408740918362472622944042343626205116929275158874549537506919120
136,1515665364,1515665362,2,147,787701287328681601520891054480870121450816222215241932241208054475599521360
137,1515665366,1515665364,2,238,486521383350068047998197416002890369131386490191767075796040268940811469075
138,1515665373,1515665366,7,386,299979505796155946693189080333388362314170944729638766941599958569723133782
139,1515665376,1515665373,3,603,192026681985598997385689859052550427617363158649486839203080570494051624610
140,1515665396,1515665376,20,979,118275882775603876837151159355145973292410607421491893809456163440156414341
141,1515665404,1515665396,8,1407,82297149422399570308152796736807326121727067992637216801320244497450696261
142,1515665405,1515665404,1,2198,52680659343637941502989529121332078186201084925223186551163595999960477543
143,1515665436,1515665405,31,3571,32425676067576643915869780176053740647793330906088088501668323721062203763
144,1515665596,1515665436,160,4686,24710219640912547038747542682178384091606910940170841664416897995713429287
145,1515665596,1515665596,0,2,57896044618658097711785492504343953926634992332820282019728792003956564819968
146,1515665596,1515665596,0,3,38597363079105398474523661669562635951089994888546854679819194669304376546645
147,1515665597,1515665596,1,4,28948022309329048855892746252171976963317496166410141009864396001978282409984
148,1515665597,1515665597,0,6,19298681539552699237261830834781317975544997444273427339909597334652188273322
149,1515665598,1515665597,1,9,12865787693035132824841220556520878650363331629515618226606398223101458848881
150,1515665598,1515665598,0,14,8270863516951156815969356072049136275233570333260040288532684571993794974281
151,1515665599,1515665598,1,22,5263276783514372519253226591303995811512272030256389274520799273086960438178
152,1515665599,1515665599,0,35,3308345406780462726387742428819654510093428133304016115413073828797517989712
153,1515665601,1515665599,2,56,2067715879237789203992339018012284068808392583315010072133171142998448743570
154,1515665602,1515665601,1,91,1272440541069408740918362472622944042343626205116929275158874549537506919120
155,1515665602,1515665602,0,147,787701287328681601520891054480870121450816222215241932241208054475599521360
156,1515665604,1515665602,2,238,486521383350068047998197416002890369131386490191767075796040268940811469075
157,1515665612,1515665604,8,386,299979505796155946693189080333388362314170944729638766941599958569723133782
158,1515665629,1515665612,17,603,192026681985598997385689859052550427617363158649486839203080570494051624610
159,1515665644,1515665629,15,904,128088594289066587857932505540583968864236708700929827477276088504328683230
160,1515665654,1515665644,10,1356,85392396192711058571955003693722645909491139133953218318184059002885788820
161,1515665656,1515665654,2,2118,54670485947741357612639747407312515511458916272729255920423788483433961114
162,1515665677,1515665656,21,3441,33650708874546990823473113922896805537131643320441895971943500147606256797
163,1515665716,1515665677,39,4946,23411259449518033850297409019144340447486854966769220388082811162133669559
164,1515665896,1515665716,180,6182,18730522361261112168160948723501764453780327509809214500074018765434022911
165,1515665897,1515665896,1,2,57896044618658097711785492504343953926634992332820282019728792003956564819968
166,1515665897,1515665897,0,3,38597363079105398474523661669562635951089994888546854679819194669304376546645
167,1515665897,1515665897,0,4,28948022309329048855892746252171976963317496166410141009864396001978282409984
168,1515665898,1515665897,1,6,19298681539552699237261830834781317975544997444273427339909597334652188273322
169,1515665898,1515665898,0,9,12865787693035132824841220556520878650363331629515618226606398223101458848881
170,1515665900,1515665898,2,14,8270863516951156815969356072049136275233570333260040288532684571993794974281
171,1515665903,1515665900,3,22,5263276783514372519253226591303995811512272030256389274520799273086960438178
172,1515665904,1515665903,1,35,3308345406780462726387742428819654510093428133304016115413073828797517989712
173,1515665907,1515665904,3,56,2067715879237789203992339018012284068808392583315010072133171142998448743570
174,1515665912,1515665907,5,91,1272440541069408740918362472622944042343626205116929275158874549537506919120
175,1515665914,1515665912,2,147,787701287328681601520891054480870121450816222215241932241208054475599521360
176,1515665917,1515665914,3,238,486521383350068047998197416002890369131386490191767075796040268940811469075
177,1515665926,1515665917,9,386,299979505796155946693189080333388362314170944729638766941599958569723133782
178,1515665936,1515665926,10,603,192026681985598997385689859052550427617363158649486839203080570494051624610
179,1515665963,1515665936,27,942,122921538468488530173642234616441515767802531492187435286048390666574447600
180,1515665978,1515665963,15,1295,89414740723796289902371416995125797570092652251459895011164157535068053776
181,1515666004,1515665978,26,1942,59625174684508854492055090117758963879129755234624389309710393412931580659
182,1515666071,1515666004,67,2670,43367823684388088173622091763553523540550556054547027730133926594724018591
183,1515666147,1515666071,76,2504,46242847139503272932736016377271528695395361288195113434288172527121856884
184,1515666157,1515666147,10,2191,52848968159432311923126875859738889937594698615080129639186482888139265011
185,1515666167,1515666157,10,3423,33827662646017001292308204793656999080709899113537997090113229333307954905
186,1515666347,1515666167,180,5348,21651475175264808418767947832589361977051231238900629027572472701554437105
187,1515666347,1515666347,0,2,57896044618658097711785492504343953926634992332820282019728792003956564819968
188,1515666348,1515666347,1,3,38597363079105398474523661669562635951089994888546854679819194669304376546645
189,1515666349,1515666348,1,4,28948022309329048855892746252171976963317496166410141009864396001978282409984
190,1515666350,1515666349,1,6,19298681539552699237261830834781317975544997444273427339909597334652188273322
191,1515666351,1515666350,1,9,12865787693035132824841220556520878650363331629515618226606398223101458848881
192,1515666352,1515666351,1,14,8270863516951156815969356072049136275233570333260040288532684571993794974281
193,1515666353,1515666352,1,22,5263276783514372519253226591303995811512272030256389274520799273086960438178
194,1515666355,1515666353,2,35,3308345406780462726387742428819654510093428133304016115413073828797517989712
195,1515666357,1515666355,2,56,2067715879237789203992339018012284068808392583315010072133171142998448743570
196,1515666360,1515666357,3,91,1272440541069408740918362472622944042343626205116929275158874549537506919120
197,1515666362,1515666360,2,147,787701287328681601520891054480870121450816222215241932241208054475599521360
198,1515666366,1515666362,4,238,486521383350068047998197416002890369131386490191767075796040268940811469075
199,1515666368,1515666366,2,386,299979505796155946693189080333388362314170944729638766941599958569723133782
200,1515666380,1515666368,12,627,184676378368925351552744792677333186368851650184434711386694711336384576778
201,1515666390,1515666380,10,940,123183073656719356833586154264561604099223387942170812807933600008418223021
202,1515666417,1515666390,27,1468,78877444984547817046029281341068057120756120344441801116796719351439461607
203,1515666447,1515666417,30,2018,57379627966955498227735869677248715487249744631140021823318921708579350663
204,1515666508,1515666447,61,2648,43728130376629983166001127269141959159089873363157312703722652570964172824
205,1515666567,1515666508,59,2648,43728130376629983166001127269141959159089873363157312703722652570964172824
206,1515666588,1515666567,21,2813,41163202715007534811081046928079597530490574001294192690884317101995424685
207,1515666718,1515666588,130,4043,28640140795774473268258962406304206740853322944754035132193317835249351877
208,1515666725,1515666718,7,1264,91607665535851420430040336241050560010498405589905509524887329120184438006
209,1515666747,1515666725,22,1975,58628905942944909075225815194272358406718979577539526095927890636918040324
210,1515666827,1515666747,80,2839,40786223753897920191465651640960869268499466243621191982901579432163835730
211,1515666904,1515666827,77,2307,50191629491684523373892928048846080560585168905782645877528211533555756237
212,1515666937,1515666904,33,2019,57351208141315599516379883610048493240846946342565905913550066373409177632
213,1515666969,1515666937,32,2649,43711622966144279133095879580478636411200447212397343918255033600571207867
214,1515667129,1515666969,160,3476,33311878376673243792741940451291112731090329305420185281777210589157977456
215,1515667139,1515667129,10,2,57896044618658097711785492504343953926634992332820282019728792003956564819968
216,1515667139,1515667139,0,3,38597363079105398474523661669562635951089994888546854679819194669304376546645
217,1515667140,1515667139,1,4,28948022309329048855892746252171976963317496166410141009864396001978282409984
218,1515667140,1515667140,0,6,19298681539552699237261830834781317975544997444273427339909597334652188273322
219,1515667141,1515667140,1,9,12865787693035132824841220556520878650363331629515618226606398223101458848881
220,1515667141,1515667141,0,14,8270863516951156815969356072049136275233570333260040288532684571993794974281
221,1515667142,1515667141,1,22,5263276783514372519253226591303995811512272030256389274520799273086960438178
222,1515667145,1515667142,3,35,3308345406780462726387742428819654510093428133304016115413073828797517989712
223,1515667146,1515667145,1,56,2067715879237789203992339018012284068808392583315010072133171142998448743570
224,1515667149,1515667146,3,91,1272440541069408740918362472622944042343626205116929275158874549537506919120
225,1515667151,1515667149,2,147,787701287328681601520891054480870121450816222215241932241208054475599521360
226,1515667169,1515667151,18,238,486521383350068047998197416002890369131386490191767075796040268940811469075
227,1515667179,1515667169,10,342,338573360343029811180032119908444175009561358671463637542273637450038390760
228,1515667198,1515667179,19,534,216839118421940440868110458817767617702752780272735138650669632973620092958
229,1515667205,1515667198,7,767,150967521821794257397093852684078106718735312471500083493425794012924549726
230,1515667229,1515667205,24,1198,96654498528644570470426531726784564151310504729249218730765929889743847779
231,1515667286,1515667229,57,1647,70304850781612747676727981183174200275209462456369498506045891929516168573
232,1515667314,1515667286,28,1749,66204739415275126028342472846591142283173233084986028610324519158326546392
233,1515667349,1515667314,35,2404,48166426471429365816793254995294470820827780642945326139541424296136909168
234,1515667372,1515667349,23,3155,36701137634648556394158790810994582520846270892437579727244876072238709870
235,1515667524,1515667372,152,4535,25532985498856933941250492835432835248791617346337500339461429770212376987
236,1515667540,1515667524,16,284,407718624075057026139334454255943337511514030512818887462878816929271583239
237,1515667580,1515667540,40,426,271812416050038017426222969503962225007676020341879258308585877952847722159
238,1515667590,1515667580,10,532,217654303077662021472877791369714112506146587717369481277175909789310394060
239,1515667595,1515667590,5,831,139340660935398550449543904944269443866750884074176370685267850791712550709
240,1515667599,1515667595,4,1350,85771917953567552165608137043472524335755544196770788177375988154009725659
241,1515667723,1515667599,124,2193,52800770286053896681974913364654768742941169478176271791818323761018298969
242,1515667740,1515667723,17,823,140695126655305219226696215077385064220255145401750381578927805598922393244
243,1515667750,1515667740,10,1234,93834756270110369062861414107526667628257686114781656433920246359735113160
244,1515667850,1515667750,100,1928,60058137571222093062018145751394143077422191216618549812996672203274444833
245,1515667868,1515667850,18,1205,96093020113955348899229033202230628923875505946589679700794675525239111734
246,1515667900,1515667868,32,1732,66854554986903115140629898965755143102349875673002635126707612013806656835
247,1515668045,1515667900,145,2273,50942406175678044621016711398454864871654194749511906748551510782187914491
248,1515668055,1515668045,10,285,406288032411635773416038543890133010011473630405756365050728364940046068912
249,1515668065,1515668055,10,445,260206942106328529041732550581321141243303336327282166380803559568344111550
250,1515668091,1515668065,26,695,166607322643620425069886309365018572450748179375022394301377818716421769266
251,1515668121,1515668091,30,955,121248260981482927145100507862500427071486894937843522554405847128704847790
252,1515668160,1515668121,39,1253,92411882870962645988484425386023868997023132215195980877460162815573128204
253,1515668201,1515668160,41,1566,73941308580661682901386325037476314082547882928250679463255162201732522120
254,1515668211,1515668201,10,1957,59168160059946957293597846197592185924001014136760635686999276447579524598
255,1515668231,1515668211,20,3057,37877687025618644234076213610954500442679092137926255819253380440926767955
256,1515668241,1515668231,10,4394,26352318897887163273457210971481089634335453952125754219266632682729433236
257,1515668281,1515668241,40,6865,16867019553869802683695700656764443969886377955665049386665343628246632139
258,1515668743,1515668281,462,8581,13494008767896072185476166531719835433314297245733663214014402051965170684
259,1515668743,1515668743,0,2,57896044618658097711785492504343953926634992332820282019728792003956564819968
260,1515668743,1515668743,0,3,38597363079105398474523661669562635951089994888546854679819194669304376546645
261,1515668744,1515668743,1,4,28948022309329048855892746252171976963317496166410141009864396001978282409984
262,1515668745,1515668744,1,6,19298681539552699237261830834781317975544997444273427339909597334652188273322
263,1515668746,1515668745,1,9,12865787693035132824841220556520878650363331629515618226606398223101458848881
264,1515668747,1515668746,1,14,8270863516951156815969356072049136275233570333260040288532684571993794974281
265,1515668750,1515668747,3,22,5263276783514372519253226591303995811512272030256389274520799273086960438178
266,1515668751,1515668750,1,35,3308345406780462726387742428819654510093428133304016115413073828797517989712
267,1515668755,1515668751,4,56,2067715879237789203992339018012284068808392583315010072133171142998448743570
268,1515668757,1515668755,2,91,1272440541069408740918362472622944042343626205116929275158874549537506919120
269,1515668765,1515668757,8,147,787701287328681601520891054480870121450816222215241932241208054475599521360
270,1515668768,1515668765,3,229,505642311079983386129130938902567283202052334784456611526015650689576985327
271,1515668772,1515668768,4,372,311269057089559665117126303786795451218467700714087537740477376365357875376
272,1515668792,1515668772,20,604,191708757015424164608561233458092562670976795804040668939499311271379353708
273,1515668841,1515668792,49,868,133401024466954142193054130194340907665057586020323230460204589870867660875
274,1515668881,1515668841,40,976,118639435693971511704478468246606462964415967895123528728952442631058534467
275,1515668931,1515668881,50,1220,94911548555177209363582774597285170371532774316098822983161954104846827573
276,1515668941,1515668931,10,1372,84396566499501600162952612980093227298301738094490207025843720122385663002
277,1515668953,1515668941,12,2143,54032706130338868606426031268636447901665881785179917890554168925764409538
278,1515669047,1515668953,94,3214,36027407976762973062716547918073400078802110972507953963739136281242417436
279,1515669103,1515669047,56,2210,52394610514622712861344337108003578214149314328344146624188952039779696669
280,1515669163,1515669103,60,2348,49315199845535006568812174194500812543982105905298366285970010224835234088
281,1515669179,1515669163,16,2348,49315199845535006568812174194500812543982105905298366285970010224835234088
282,1515669293,1515669179,114,3522,32876799897023337712541449463000541695988070603532244190646673483223489392
283,1515669314,1515669293,21,1541,75140875559582216368313423107519732545924714254147024035988049323759331369
284,1515669369,1515669314,55,2215,52276338256124693193485772012951651401024823776812895728874755759780193968
285,1515669393,1515669369,24,2353,49210407665667741361483631537903913239808748264190634950895700810842809026
286,1515669502,1515669393,109,3235,35793536085723708013468619786302289908275111179487036797359376818520287369
287,1515669520,1515669502,18,1618,71564950084867858729030275036271883716483303254413203979887258348524802002
288,1515669552,1515669520,32,2325,49803049134329546418740208605887272194954832114254006038476380218457260060
289,1515669583,1515669552,31,3051,37952176085649359365313334974987842626440506281756985919192915112393683920
290,1515669745,1515669583,162,4004,28919103206122925929962783468703273689627868298112028980883512489488793616
291,1515669754,1515669745,9,2,57896044618658097711785492504343953926634992332820282019728792003956564819968
292,1515669754,1515669754,0,3,38597363079105398474523661669562635951089994888546854679819194669304376546645
293,1515669755,1515669754,1,4,28948022309329048855892746252171976963317496166410141009864396001978282409984
294,1515669756,1515669755,1,6,19298681539552699237261830834781317975544997444273427339909597334652188273322
295,1515669757,1515669756,1,9,12865787693035132824841220556520878650363331629515618226606398223101458848881
296,1515669758,1515669757,1,14,8270863516951156815969356072049136275233570333260040288532684571993794974281
297,1515669759,1515669758,1,22,5263276783514372519253226591303995811512272030256389274520799273086960438178
298,1515669764,1515669759,5,35,3308345406780462726387742428819654510093428133304016115413073828797517989712
299,1515669765,1515669764,1,56,2067715879237789203992339018012284068808392583315010072133171142998448743570
300,1515669767,1515669765,2,91,1272440541069408740918362472622944042343626205116929275158874549537506919120
301,1515669775,1515669767,8,147,787701287328681601520891054480870121450816222215241932241208054475599521360
302,1515669778,1515669775,3,229,505642311079983386129130938902567283202052334784456611526015650689576985327
303,1515669783,1515669778,5,372,311269057089559665117126303786795451218467700714087537740477376365357875376
304,1515669854,1515669783,71,604,191708757015424164608561233458092562670976795804040668939499311271379353708
305,1515669864,1515669854,10,567,204218852270398933727638421532077438894656057611359019469942828938118394426
306,1515669904,1515669864,40,885,130838518912221689744148005659534359156237270808633405694302354811201276429
307,1515669939,1515669904,35,1106,104694474898115909062903241418343497154855320674177725171299804708782214864
308,1515669964,1515669939,25,1451,79801577696289590229890410068013720091846991499407694031328452107452191343
309,1515670084,1515669964,120,1995,58041147487376539059434077698590430001639090057965195007246909277149438416
310,1515670094,1515670084,10,749,154595579756096389083539365832694135985674211836636267075377281719510186435
311,1515670103,1515670094,9,1170,98967597638731790960317081204006758848948704842427832512356909408472760376
312,1515670113,1515670103,10,1828,63343593674680632069787190923789883945990144784267266980009619260346351006
313,1515670185,1515670113,72,2856,40543448612505670666516451333574197427615540849313922983003355745067622422
314,1515670194,1515670185,9,2499,46335369842863623618875944381227654202989189542073054837718120851505854197
315,1515670252,1515670194,58,3904,29659858923492877926119617061651615741103991973780882182238110657764633616
316,1515670325,1515670252,73,4148,27915161339758002753994933705083873638686110092970242053871162972013772815
317,1515670354,1515670325,29,3630,31898647172814378904565009644266641281892557759129631966792722867193699625
318,1515670414,1515670354,60,4991,23200178168165937772705066120754940463488275829621431384383406934063941021
319,1515670483,1515670414,69,4991,23200178168165937772705066120754940463488275829621431384383406934063941021
320,1515670865,1515670483,382,4680,24741899409682947740079270301001689712237176210606958128089227352118190094
321,1515670865,1515670865,0,2,57896044618658097711785492504343953926634992332820282019728792003956564819968
322,1515670865,1515670865,0,3,38597363079105398474523661669562635951089994888546854679819194669304376546645
323,1515670866,1515670865,1,4,28948022309329048855892746252171976963317496166410141009864396001978282409984
324,1515670866,1515670866,0,6,19298681539552699237261830834781317975544997444273427339909597334652188273322
325,1515670867,1515670866,1,9,12865787693035132824841220556520878650363331629515618226606398223101458848881
326,1515670869,1515670867,2,14,8270863516951156815969356072049136275233570333260040288532684571993794974281
327,1515670875,1515670869,6,22,5263276783514372519253226591303995811512272030256389274520799273086960438178
328,1515670876,1515670875,1,34,3405649683450476335987381912020232583919705431342369530572281882585680283527
329,1515670876,1515670876,0,55,2105310713405749007701290636521598324604908812102555709808319709234784175271
330,1515670878,1515670876,2,89,1301034710531642645208662752906605706216516681636410831904017797841720557752
331,1515670881,1515670878,3,144,804111730814695801552576284782554915647708226844726139162899888943841178055
332,1515670882,1515670881,1,234,494837988193658954801585406020033794244743524212139162561784547042363801880
333,1515670885,1515670882,3,380,304716024308726830062028907917599757508605222804317273788046273705034551684
334,1515670891,1515670885,6,617,187669512540220738125722828215053335256515372229563312867840492719470226320
335,1515670940,1515670891,49,964,120116275142444186124036291502788286154844382433237099625993344406548889667
336,1515670955,1515670940,15,1084,106819270514129331571559949270007295067592236776421184538245003697336835461
337,1515670995,1515670955,40,1626,71212847009419554381039966180004863378394824517614123025496669131557890307
338,1515671015,1515670995,20,2032,56984295884506001684828240653881844415979323162224687027292118114130477185
339,1515671025,1515671015,10,2921,39641249310960696824228341324439543941550833504156304018985821296786418911
340,1515671067,1515671025,42,4564,25370746984512750969231153595242749310532424335153497817584921999980966178
341,1515671086,1515671067,19,5419,21367796500704225027416679278222533281651593405728098180376007382895945680
342,1515671137,1515671086,51,7789,14866104665209422958476182437885210919664910086742914885024725126192467536
343,1515671196,1515671137,59,8762,13215257844934512146036405502018706671224604504181758050611456745938499160
344,1515671370,1515671196,174,9309,12438724807961778432008914492285735079307120492602918040547597379730704655
345,1515671371,1515671370,1,2,57896044618658097711785492504343953926634992332820282019728792003956564819968
346,1515671372,1515671371,1,3,38597363079105398474523661669562635951089994888546854679819194669304376546645
347,1515671373,1515671372,1,4,28948022309329048855892746252171976963317496166410141009864396001978282409984
348,1515671374,1515671373,1,6,19298681539552699237261830834781317975544997444273427339909597334652188273322
349,1515671374,1515671374,0,9,12865787693035132824841220556520878650363331629515618226606398223101458848881
350,1515671376,1515671374,2,14,8270863516951156815969356072049136275233570333260040288532684571993794974281
351,1515671376,1515671376,0,22,5263276783514372519253226591303995811512272030256389274520799273086960438178
352,1515671378,1515671376,2,35,3308345406780462726387742428819654510093428133304016115413073828797517989712
353,1515671385,1515671378,7,56,2067715879237789203992339018012284068808392583315010072133171142998448743570
354,1515671386,1515671385,1,87,1330943554451910292224953850674573653485861892708512230338592919631185398160
355,1515671389,1515671386,3,141,821220491044795712223907695097077360661489252947805418719557333389454820141
356,1515671397,1515671389,8,229,505642311079983386129130938902567283202052334784456611526015650689576985327
357,1515671405,1515671397,8,357,324347588900045365332131610668593579420924326794511383864026845960540979383
358,1515671406,1515671405,1,557,207885258953889040257757603247195525768886866545135662548397816890328778527
359,1515671432,1515671406,26,905,127947059930736127539857441998550174423502745486895650872328822108191303469
360,1515671457,1515671432,25,1244,93080457586267038121841627820488671907773299570450614179628282964560393601
361,1515671476,1515671457,19,1710,67714672068605962236006423981688835001912271734292727508454727490007678152
362,1515671506,1515671476,30,2458,47108254368314155990061425959596382365040677243954663970487218880355219544
363,1515671596,1515671506,90,3226,35893394059924425115800057349252296296735891092883001872119523871020808939
364,1515671657,1515671596,61,2218,52205630855417581345162752483628452593899902915076899927618387740267416429
365,1515671717,1515671657,60,2218,52205630855417581345162752483628452593899902915076899927618387740267416429
366,1515671759,1515671717,42,2218,52205630855417581345162752483628452593899902915076899927618387740267416429
367,1515671766,1515671759,7,2633,43977246197233648090987840869232019693608045828196188393261520701828002142
368,1515671778,1515671766,12,4114,28145865152483275504027949686117624660493433316879087029522990765170911434
369,1515671957,1515671778,179,6171,18763910101655517002685299790745083106995622211252724686348660510113940956
370,1515671967,1515671957,10,2,57896044618658097711785492504343953926634992332820282019728792003956564819968
371,1515671968,1515671967,1,3,38597363079105398474523661669562635951089994888546854679819194669304376546645
372,1515671969,1515671968,1,4,28948022309329048855892746252171976963317496166410141009864396001978282409984
373,1515671969,1515671969,0,6,19298681539552699237261830834781317975544997444273427339909597334652188273322
374,1515671970,1515671969,1,9,12865787693035132824841220556520878650363331629515618226606398223101458848881
375,1515671971,1515671970,1,14,8270863516951156815969356072049136275233570333260040288532684571993794974281
376,1515671972,1515671971,1,22,5263276783514372519253226591303995811512272030256389274520799273086960438178
377,1515671974,1515671972,2,35,3308345406780462726387742428819654510093428133304016115413073828797517989712
378,1515671975,1515671974,1,56,2067715879237789203992339018012284068808392583315010072133171142998448743570
379,1515671976,1515671975,1,91,1272440541069408740918362472622944042343626205116929275158874549537506919120
380,1515671978,1515671976,2,147,787701287328681601520891054480870121450816222215241932241208054475599521360
381,1515671983,1515671978,5,238,486521383350068047998197416002890369131386490191767075796040268940811469075
382,1515672006,1515671983,23,386,299979505796155946693189080333388362314170944729638766941599958569723133782
383,1515672015,1515672006,9,554,209010991403097825674315857416404165800126326111264556027901776187568826064
384,1515672019,1515672015,4,865,133863686979556295287365300588078506188751427359122039351974085558281074728
385,1515672066,1515672019,47,1405,82414298389548893539908174383407763596633441043160543800325682567909700811
386,1515672088,1515672066,22,1668,69419717768175177112452628902091071854478408072925997625574091131842403860
387,1515672118,1515672088,30,2397,48307087708517394836700452652769256509499367820459142277621019611144401184
388,1515672208,1515672118,90,3146,36806131353247360274498088051076893786799105106688036884760834077531191875
389,1515672248,1515672208,40,2163,53533097197094866122779003702583406312191393742783432288237440595429093684
390,1515672400,1515672248,152,2703,42838360798119199194809835371323680300876797878520371453739394749505412371
391,1515672409,1515672400,9,169,685160291345066245109887485258508330492721802755269609700932449750965264141
392,1515672426,1515672409,17,264,438606398626197709937768882608666317626022669188032439543399939423913369848
393,1515672437,1515672426,11,396,292404265750798473291845921739110878417348446125354959695599959615942246565
394,1515672448,1515672437,11,618,187365840189832031429726512959041922092669878099742013008831042084001827896
395,1515672463,1515672448,15,965,119991802318462378677275632133355344925668377891855506776639983427889253512
396,1515672487,1515672463,24,1447,80022176390681544867706278513260475365079464178051530089466194891439619654
397,1515672610,1515672487,123,1989,58216233905136347623715930120003975793499238142604607360209946710866329632
398,1515672641,1515672610,31,746,155217277798010985822481213148375211599557620195228638122597297597738779678
399,1515672667,1515672641,26,979,118275882775603876837151159355145973292410607421491893809456163440156414341
400,1515672689,1515672667,22,1346,86026812211973399274569825415072739861270419513848858870325099560113766448
401,1515672700,1515672689,11,1934,59871814497061114489953973634275029913790064460000291643980136508745154932
402,1515672739,1515672700,39,3021,38329059661475072963777221121710661321837134943939279721766826881136421595
403,1515672787,1515672739,48,3776,30665277870051958533784688826453365427243110345773454459602114408875299163
404,1515672840,1515672787,53,4248,27258024773379518696697501179069658157549431418465292852979657252333599256
405,1515672906,1515672840,66,4779,24229355354115127730397778825839696140043939038635815869315250890963199338
406,1515673050,1515672906,144,4481,25840680481436330154780402813811182292628874060620523106328405268447473697
407,1515673071,1515673050,21,561,206403011118210687029538297698195914176951844323779971549835265611253350516
408,1515673081,1515673071,10,806,143662641733642922361750601747751746716215861868040402034066481399395942481
409,1515673121,1515673081,40,1259,91971476757201108358674332810713191305218415143479399554771710887937354757
410,1515673181,1515673121,60,1573,73612262706494720548996176102153787573598210213376073769521668155062383750
411,1515673190,1515673181,9,1573,73612262706494720548996176102153787573598210213376073769521668155062383750
412,1515673251,1515673190,61,2457,47127427447015138552531943430479408975689859448775158339217575908796552560
413,1515673261,1515673251,10,2457,47127427447015138552531943430479408975689859448775158339217575908796552560
414,1515673311,1515673261,50,3839,30162044604666891227812186769650405796631931405480740828199422768406650075
415,1515673521,1515673311,210,4318,26816139239767530204625054425356162078107916782223382130490408524296695145
416,1515673531,1515673521,10,2,57896044618658097711785492504343953926634992332820282019728792003956564819968
417,1515673531,1515673531,0,3,38597363079105398474523661669562635951089994888546854679819194669304376546645
418,1515673532,1515673531,1,4,28948022309329048855892746252171976963317496166410141009864396001978282409984
419,1515673532,1515673532,0,6,19298681539552699237261830834781317975544997444273427339909597334652188273322
420,1515673533,1515673532,1,9,12865787693035132824841220556520878650363331629515618226606398223101458848881
421,1515673533,1515673533,0,14,8270863516951156815969356072049136275233570333260040288532684571993794974281
422,1515673534,1515673533,1,22,5263276783514372519253226591303995811512272030256389274520799273086960438178
423,1515673535,1515673534,1,35,3308345406780462726387742428819654510093428133304016115413073828797517989712
424,1515673536,1515673535,1,56,2067715879237789203992339018012284068808392583315010072133171142998448743570
425,1515673541,1515673536,5,91,1272440541069408740918362472622944042343626205116929275158874549537506919120
426,1515673543,1515673541,2,147,787701287328681601520891054480870121450816222215241932241208054475599521360
427,1515673551,1515673543,8,238,486521383350068047998197416002890369131386490191767075796040268940811469075
428,1515673552,1515673551,1,371,312108057243439879847900229133929670763530955972076992020101304603539432991
429,1515673582,1515673552,30,602,192345663184910623627194327256956657563571403099070704384481036557995231960
430,1515673591,1515673582,9,790,146572264857362272688064537985680896016797448943848815239819726592295100810
431,1515673601,1515673591,10,1234,93834756270110369062861414107526667628257686114781656433920246359735113160
432,1515673641,1515673601,40,1928,60058137571222093062018145751394143077422191216618549812996672203274444833
433,1515673673,1515673641,32,2410,48046510056977674449614516601115314461937752973294839850397337762619555867
434,1515673682,1515673673,9,3163,36608311488244133867711345244605724898283270523439950692209163454920369788
435,1515673702,1515673682,20,4942,23430208263317724691131320317419649504910964116883966823038766492900269048
436,1515673732,1515673702,30,7104,16299562111108698680119789556403140182048139733339043361410132883996780636
437,1515673943,1515673732,211,9324,12418713989416151375329363471545249662512868368258318751550577435426118580
438,1515673953,1515673943,10,2,57896044618658097711785492504343953926634992332820282019728792003956564819968
439,1515673953,1515673953,0,3,38597363079105398474523661669562635951089994888546854679819194669304376546645
440,1515673954,1515673953,1,4,28948022309329048855892746252171976963317496166410141009864396001978282409984
441,1515673955,1515673954,1,6,19298681539552699237261830834781317975544997444273427339909597334652188273322
442,1515673955,1515673955,0,9,12865787693035132824841220556520878650363331629515618226606398223101458848881
443,1515673956,1515673955,1,14,8270863516951156815969356072049136275233570333260040288532684571993794974281
444,1515673957,1515673956,1,22,5263276783514372519253226591303995811512272030256389274520799273086960438178
445,1515673963,1515673957,6,35,3308345406780462726387742428819654510093428133304016115413073828797517989712
446,1515673965,1515673963,2,54,2144297948839188804140203426086813108393888604919269704434399703850243141480
447,1515673965,1515673965,0,87,1330943554451910292224953850674573653485861892708512230338592919631185398160
448,1515673966,1515673965,1,141,821220491044795712223907695097077360661489252947805418719557333389454820141
449,1515673970,1515673966,4,229,505642311079983386129130938902567283202052334784456611526015650689576985327
450,1515673972,1515673970,2,372,311269057089559665117126303786795451218467700714087537740477376365357875376
451,1515674007,1515673972,35,604,191708757015424164608561233458092562670976795804040668939499311271379353708
452,1515674015,1515674007,8,792,146202132875399236645922960869555439208674223062677479847799979807971123282
453,1515674082,1515674015,67,1237,93607186125558767521075978180022560916143884127437804397297966053284664219
454,1515674142,1515674082,60,1160,99820766583893271916871538800593024011439641953138417275394468972338904862
455,1515674169,1515674142,27,1160,99820766583893271916871538800593024011439641953138417275394468972338904862
456,1515674203,1515674169,34,1595,72596921151922379575906573673158562917410648693191576200286886525337385354
457,1515674213,1515674203,10,2093,55323501785626466996450542287954088797548965439866490224298893458152474744
458,1515674413,1515674213,200,3270,35410424843215961903232717128039115551458710906923719889742380430554473896
459,1515674423,1515674413,10,2,57896044618658097711785492504343953926634992332820282019728792003956564819968
460,1515674424,1515674423,1,3,38597363079105398474523661669562635951089994888546854679819194669304376546645
461,1515674424,1515674424,0,4,28948022309329048855892746252171976963317496166410141009864396001978282409984
462,1515674425,1515674424,1,6,19298681539552699237261830834781317975544997444273427339909597334652188273322
463,1515674426,1515674425,1,9,12865787693035132824841220556520878650363331629515618226606398223101458848881
464,1515674429,1515674426,3,14,8270863516951156815969356072049136275233570333260040288532684571993794974281
465,1515674430,1515674429,1,22,5263276783514372519253226591303995811512272030256389274520799273086960438178
466,1515674431,1515674430,1,35,3308345406780462726387742428819654510093428133304016115413073828797517989712
467,1515674432,1515674431,1,56,2067715879237789203992339018012284068808392583315010072133171142998448743570
468,1515674438,1515674432,6,91,1272440541069408740918362472622944042343626205116929275158874549537506919120
469,1515674443,1515674438,5,142,815437248150114052278668908511886675023028061025637774925757633858543166478
470,1515674448,1515674443,5,230,503443866249200849667699934820382208057695585502785061041119930469187520173
471,1515674453,1515674448,5,373,310434555596021971644962426296750423199115240390457276245194595195477559356
472,1515674458,1515674453,5,606,191076054847056428091701295393874435401435618260132943959500963709427606666
473,1515674462,1515674458,4,984,117674887436296946568669700212081207167957301489472117926278032528367001666
474,1515674563,1515674462,101,1599,72415315345413505580719815515126896718742954762752072570017250786687385640
475,1515674585,1515674563,22,1000,115792089237316195423570985008687907853269984665640564039457584007913129639
476,1515674604,1515674585,19,1437,80579046094165758819464846909316567747578277429116606847221700770990347696
477,1515674614,1515674604,10,2065,56073650962380724176063430996943296781244544632271459583272437776229118469
478,1515674670,1515674614,56,3226,35893394059924425115800057349252296296735891092883001872119523871020808939
479,1515675135,1515674670,465,3427,33788178942899385883738250659086054232060106409582890002759726877126679206
480,1515675145,1515675135,10,2,57896044618658097711785492504343953926634992332820282019728792003956564819968
481,1515675145,1515675145,0,3,38597363079105398474523661669562635951089994888546854679819194669304376546645
482,1515675146,1515675145,1,4,28948022309329048855892746252171976963317496166410141009864396001978282409984
483,1515675147,1515675146,1,6,19298681539552699237261830834781317975544997444273427339909597334652188273322
484,1515675148,1515675147,1,9,12865787693035132824841220556520878650363331629515618226606398223101458848881
485,1515675149,1515675148,1,14,8270863516951156815969356072049136275233570333260040288532684571993794974281
486,1515675150,1515675149,1,22,5263276783514372519253226591303995811512272030256389274520799273086960438178
487,1515675152,1515675150,2,35,3308345406780462726387742428819654510093428133304016115413073828797517989712
488,1515675156,1515675152,4,56,2067715879237789203992339018012284068808392583315010072133171142998448743570
489,1515675160,1515675156,4,91,1272440541069408740918362472622944042343626205116929275158874549537506919120
490,1515675164,1515675160,4,147,787701287328681601520891054480870121450816222215241932241208054475599521360
491,1515675176,1515675164,12,238,486521383350068047998197416002890369131386490191767075796040268940811469075
492,1515675186,1515675176,10,357,324347588900045365332131610668593579420924326794511383864026845960540979383
493,1515675206,1515675186,20,557,207885258953889040257757603247195525768886866545135662548397816890328778527
494,1515675257,1515675206,51,800,144740111546645244279463731260859884816587480832050705049321980009891412049
495,1515675276,1515675257,19,900,128657876930351328248412205565208786503633316295156182266063982231014588488
496,1515675323,1515675276,47,1293,89553046587251504581261395985064120536171681875978781159673305497225931662
497,1515675333,1515675323,10,1535,75434585822355827637505527692956291761087937892925448885640119874861973706
498,1515675425,1515675333,92,2398,48286942968021766231680977901871521206534605782168708940557791496210646221
499,1515675465,1515675425,40,1649,70219581102071677030667668289076960493189802708090093413861482115168665639
500,1515675546,1515675465,81,2061,56182479008887042903236770989174142578005814976050734614001738965508553925
501,1515675568,1515675546,22,1675,69129605514815639058848349258918153942250737113815262113109005377858584859
502,1515675587,1515675568,19,2407,48106393534406396104516404241249650125995008170187189048382876613175375837
503,1515675602,1515675587,15,3460,33465921744889073821841325147019626547187856839780509837993521389570268682
504,1515675617,1515675602,15,5190,22310614496592715881227550098013084364791904559853673225329014259713512454
505,1515675996,1515675617,379,7785,14873742997728477254151700065342056243194603039902448816886009506475674969
506,1515675997,1515675996,1,2,57896044618658097711785492504343953926634992332820282019728792003956564819968
507,1515675997,1515675997,0,3,38597363079105398474523661669562635951089994888546854679819194669304376546645
508,1515675998,1515675997,1,4,28948022309329048855892746252171976963317496166410141009864396001978282409984
509,1515675998,1515675998,0,6,19298681539552699237261830834781317975544997444273427339909597334652188273322
510,1515676006,1515675998,8,9,12865787693035132824841220556520878650363331629515618226606398223101458848881
511,1515676006,1515676006,0,14,8270863516951156815969356072049136275233570333260040288532684571993794974281
512,1515676007,1515676006,1,22,5263276783514372519253226591303995811512272030256389274520799273086960438178
513,1515676010,1515676007,3,35,3308345406780462726387742428819654510093428133304016115413073828797517989712
514,1515676017,1515676010,7,56,2067715879237789203992339018012284068808392583315010072133171142998448743570
515,1515676023,1515676017,6,87,1330943554451910292224953850674573653485861892708512230338592919631185398160
516,1515676028,1515676023,5,135,857719179535675521656081370434725243357555441967707881773759881540097256592
517,1515676043,1515676028,15,219,528731001083635595541420022870721040425890340938998009312591707798690089680
518,1515676047,1515676043,4,328,353024662308890839706009100636243621503871904468416353778834097585101004999
519,1515676056,1515676047,9,533,217245946036240516742159446545380690156228864288256217710051752360062156922
520,1515676066,1515676056,10,832,139173184179466581037945895443134504631334116184664139470501903855664819278
521,1515676084,1515676066,18,1300,89070837874858611864285373083606082964053834358185049261121218467625484338
522,1515676095,1515676084,11,1868,61987199805843787699984467349404661591686287294240130642107914351131225717
523,1515676096,1515676095,1,2918,39682004536434611180113428721277555809893757596175655942240433176118276093
524,1515676243,1515676096,147,4741,24423558160159501249434926177744760146228640511630576679910901499243435908
525,1515676251,1515676243,8,593,195264905965120059736207394618360721506357478356898084383570967972872056728
526,1515676289,1515676251,38,926,125045452740082284474698687914349792498131732900259788379543827222368390539
527,1515676323,1515676289,34,1157,100079593117818665016050980992815823555116667818185448608001369064747735211
528,1515676427,1515676323,104,1518,76279373674121340858742414366724576978438725076179554703199989465028412147
529,1515676440,1515676427,13,854,135587926507396013376546820853264529102189677594426889975945648721209753676
530,1515676441,1515676440,1,1281,90391951004930675584364547235509686068126451729617926650630432480806502451
531,1515676540,1515676441,99,2081,55642522459065927642273419033487701995804894120922904391858521868290787909
532,1515676557,1515676540,17,1301,89002374509851034145711748661558730094750180373282524242473162189018546994
533,1515676567,1515676557,10,1951,59350122622919628612799069712295185983223979838872662244724543315178436514
534,1515676577,1515676567,10,3048,37989530589670667789885493769254562943986215441483124684861412076086984790
535,1515676639,1515676577,62,4762,24315852422787945280044305965705146546255771664351231423657619489271971784
536,1515676688,1515676639,49,4762,24315852422787945280044305965705146546255771664351231423657619489271971784
537,1515676699,1515676688,11,5357,21615099726958408703298671832870619349126373840888662318360571963396141429
538,1515676780,1515676699,81,8370,13834180315091540671872280168302020054154120031737223899576772282904794461
539,1515676801,1515676780,21,6801,17025744631277193857310834437389782069294219183302538456029640348171317400
